
#@@%..@%%@@#
###..@@%%###
##..%@@%%###
#..%%@@%%@@#
............
#@@%%@@%%..#
###%%@@%..##
###%%@@..###
#@@%%@..%@@#